1111111111111
100100000C001
1000011111111
10P011E000001
1111111111111