1111111111111
100100000C0012
1000011111001
10P011E000001
11111111111113